33
55
1
1
31
53
0000000000000000000000000000000000000000000000000000000
0101111111011111110101110111111111111111111111011111010
0101010101010101010100000101000001000100010101010001010
0111111111011111111111111111110111111111011111111111010
0101010100000100010100010101000001010001010100010000010
0111110111011111110111111101111111011111011111010111110
0101010000000000010101000100000101010001010101000001000
0101110111110101111111011111111101111111010111111111010
0101000101000100000101010101010101010100010001010001010
0111011111011101111101011111111111011111111111111111110
0101010001010101000100010000000101010101010101010101010
0111011111110111110111011111011111110111111111110111110
0101000101000001000001000100010001010101000100010101010
0101111111110111111111111101111111011111111111111101110
0101010001010101000101010100010101000101000101010101010
0101011111110111111111111111111111111111011111111101110
0100000101010001010101010101000101010101010001010001010
0111111111110101110111110111010111111111111111111111110
0101010001010101000001010101010101010101010101010100010
0101111101111111111111111111111111111111111111111101110
0000010001010101000101000101010001010101000101010101010
0111010111111101011111111111111111111111111111111101110
0101000100010001010101000101010001010100010101010001010
0111111111111111110101011111011111111101110101010111110
0101000101000100010100000100010001010100010001010100010
0111111111011111110111111111111111011101111111111111110
0101010101010100000101010101010101010100000101000101010
0111010111011101111111011111110101111111111101011111110
0101000000010101010101010101010101000101010001010101010
0111010101111101111111111101111111011111111111111111110
0101010101000101010101000001000100010001010100010101000
0101010111011101111111110111011101111111111101011111110
0000000000000000000000000000000000000000000000000000000